"filename", "language", "Markdown", "Rust", "TOML", "pestfile", "comment", "blank", "total"
"d:\HuaweiMoveData\Users\Simon\Desktop\Extra\rust\MrMath\Cargo.lock", "TOML", 0, 0, 220, 0, 2, 30, 252
"d:\HuaweiMoveData\Users\Simon\Desktop\Extra\rust\MrMath\Cargo.toml", "TOML", 0, 0, 9, 0, 0, 1, 10
"d:\HuaweiMoveData\Users\Simon\Desktop\Extra\rust\MrMath\README.md", "Markdown", 28, 0, 0, 0, 0, 2, 30
"d:\HuaweiMoveData\Users\Simon\Desktop\Extra\rust\MrMath\src\backend\bigint\fraction.rs", "Rust", 0, 136, 0, 0, 0, 36, 172
"d:\HuaweiMoveData\Users\Simon\Desktop\Extra\rust\MrMath\src\backend\bigint\matrix.rs", "Rust", 0, 378, 0, 0, 0, 58, 436
"d:\HuaweiMoveData\Users\Simon\Desktop\Extra\rust\MrMath\src\backend\bigint\mod.rs", "Rust", 0, 534, 0, 0, 6, 81, 621
"d:\HuaweiMoveData\Users\Simon\Desktop\Extra\rust\MrMath\src\backend\driver.rs", "Rust", 0, 26, 0, 0, 0, 3, 29
"d:\HuaweiMoveData\Users\Simon\Desktop\Extra\rust\MrMath\src\backend\interpreter\mod.rs", "Rust", 0, 665, 0, 0, 18, 32, 715
"d:\HuaweiMoveData\Users\Simon\Desktop\Extra\rust\MrMath\src\backend\mod.rs", "Rust", 0, 5, 0, 0, 0, 0, 5
"d:\HuaweiMoveData\Users\Simon\Desktop\Extra\rust\MrMath\src\backend\parser\mod.rs", "Rust", 0, 391, 0, 0, 39, 51, 481
"d:\HuaweiMoveData\Users\Simon\Desktop\Extra\rust\MrMath\src\backend\parser\token.pest", "pestfile", 0, 0, 0, 38, 6, 7, 51
"d:\HuaweiMoveData\Users\Simon\Desktop\Extra\rust\MrMath\src\backend\structure\ast.rs", "Rust", 0, 206, 0, 0, 15, 31, 252
"d:\HuaweiMoveData\Users\Simon\Desktop\Extra\rust\MrMath\src\backend\structure\mod.rs", "Rust", 0, 1, 0, 0, 0, 0, 1
"d:\HuaweiMoveData\Users\Simon\Desktop\Extra\rust\MrMath\src\frontend\help.rs", "Rust", 0, 8, 0, 0, 0, 0, 8
"d:\HuaweiMoveData\Users\Simon\Desktop\Extra\rust\MrMath\src\frontend\history.rs", "Rust", 0, 15, 0, 0, 0, 3, 18
"d:\HuaweiMoveData\Users\Simon\Desktop\Extra\rust\MrMath\src\frontend\mod.rs", "Rust", 0, 3, 0, 0, 0, 0, 3
"d:\HuaweiMoveData\Users\Simon\Desktop\Extra\rust\MrMath\src\frontend\service.rs", "Rust", 0, 32, 0, 0, 2, 2, 36
"d:\HuaweiMoveData\Users\Simon\Desktop\Extra\rust\MrMath\src\hello.rs", "Rust", 0, 17, 0, 0, 1, 3, 21
"d:\HuaweiMoveData\Users\Simon\Desktop\Extra\rust\MrMath\src\main.rs", "Rust", 0, 8, 0, 0, 0, 1, 9
"Total", "-", 28, 2425, 229, 38, 89, 341, 3150